15
15
XXXXXXXXXXXXXXX
X_____________X
X_____________X
X_____________X
X_____________X
X______X______X
X______X______X
X______X______X
X_____________X
X_____________X
X_____________X
X_____________X
X_____________X
X_____________X
XXXXXXXXXXXXXXX