20
15
XXXXXXXXXXXXXXXXXXXX
X__________________X
X___________________
X__________________X
X__________________X
X______X___________X
X______X___________X
X______X___________X
X__________________X
X__________________X
X__________________X
X__________________X
X__________________X
X__________________X
XXXXXXXXXXXXXXXXXXXX