20
15
XXXXXXXXXXXXXXXXXXXX
X__________________X
X__________________X
X__________________X
X__________________X
X__________________X
X________X_X_______X
_________X_X________
X________X_X_______X
X__________________X
X__________________X
X__________________X
X__________________X
X__________________X
XXXXXXXXXXXXXXXXXXXX